# COMPREHENSIVE ARABIC LEXICON LIBRARY
# Standard and Complex Arabic with Annotated Meanings
# Generated for Falaqi Program Enhancement

## BASIC ARABIC VOCABULARY (الأساسية)

# Articles & Particles
ال - Al (The definite article)
و - Wa (And)
ف - Fa (So/Then)
ل - Li (For/To)
ب - Bi (With/By)
مِن - Min (From)
إلى - Ila (To/Until)
على - Ala (On/Upon)
في - Fi (In)
أن - An (That)
إن - Inna (Verily)
لَا - La (No/Not)
لَكِنَ - Lakin (But)
بَلْ - Bal (Rather)
ثُمَّ - Thumma (Then)
أو - Aw (Or)
حَتَّى - Hatta (Until)

# Pronouns
أنا - Ana (I)
أنتَ - Anta (You - masculine)
أنتِ - Anti (You - feminine)
هو - Huwa (He)
هي - Hiya (She)
نحن - Nahnu (We)
أنتم - Antum (You - plural masculine)
أنتن - Antunna (You - plural feminine)
هم - Hum (They - masculine)
هن - Hunna (They - feminine)

## RELIGIOUS & SPIRITUAL TERMINOLOGY (الدينية)

# Divine Names & Attributes
الله - Allah (God/The Creator)
الرحمن - Ar-Rahman (The Most Merciful)
الرحيم - Ar-Rahim (The Most Compassionate)
الملك - Al-Malik (The Sovereign)
القدوس - Al-Quddus (The Most Holy)
السلام - As-Salam (The Source of Peace)
المؤمن - Al-Mu'min (The Bestower of Faith)
المهيمن - Al-Muhaymin (The Protector)
العزيز - Al-Aziz (The Mighty)
الجبار - Al-Jabbar (The Compeller)
المتكبر - Al-Mutakabbir (The Supreme)
الخالق - Al-Khaliq (The Creator)
البارئ - Al-Bari' (The Maker of Order)
المصور - Al-Musawwir (The Shaper of Forms)
الغفار - Al-Ghaffar (The Forgiver)
القهار - Al-Qahhar (The Subduer)
الوهاب - Al-Wahhab (The Bestower)
الرزاق - Ar-Razzaq (The Provider)
الفتاح - Al-Fattah (The Opener)
العليم - Al-Alim (The All-Knowing)
القابض - Al-Qabid (The Restrainer)
الباسط - Al-Basit (The Expander)
الخافض - Al-Khafid (The Abaser)
الرافع - Ar-Rafi' (The Exalter)
المعز - Al-Mu'izz (The Honorer)
المذل - Al-Mudhill (The Humiliator)
السميع - As-Sami' (The All-Hearing)
البصير - Al-Baseer (The All-Seeing)
الحكم - Al-Hakam (The Judge)
العدل - Al-Adl (The Just)
اللطيف - Al-Latif (The Subtle)
الخبير - Al-Khabir (The Acquainted)
الحليم - Al-Halim (The Forbearing)
العظيم - Al-Azim (The Magnificent)
الغفور - Al-Ghafur (The Most Forgiving)
الشكور - Ash-Shakur (The Appreciative)
العلي - Al-Ali (The Most High)
الكبير - Al-Kabir (The Most Great)
الحفيظ - Al-Hafiz (The Preserver)
المقيت - Al-Muqit (The Sustainer)
الحسيب - Al-Hasib (The Reckoner)
الجليل - Al-Jalil (The Majestic)
الكريم - Al-Karim (The Most Generous)
الرقيب - Ar-Raqib (The Watchful)
المجيب - Al-Mujib (The Responsive)
الواسع - Al-Wasi' (The All-Encompassing)
الحكيم - Al-Hakim (The Wise)
الودود - Al-Wadud (The Loving)
المجيد - Al-Majid (The Most Glorious)
الباعث - Al-Ba'ith (The Resurrector)
الشهيد - Ash-Shahid (The Witness)
الحق - Al-Haqq (The Truth)
الوكيل - Al-Wakil (The Trustee)
القوي - Al-Qawiyy (The Most Strong)
المتين - Al-Matin (The Firm)
الولي - Al-Waliyy (The Protecting Friend)
الحميد - Al-Hamid (The Praiseworthy)
المحصي - Al-Muhsi (The Reckoner)
المبدئ - Al-Mubdi' (The Originator)
المعيد - Al-Mu'id (The Restorer)
المحيي - Al-Muhyi (The Giver of Life)
المميت - Al-Mumit (The Taker of Life)
الحي - Al-Hayy (The Ever-Living)
القيوم - Al-Qayyum (The Sustainer)
الواجد - Al-Wajid (The Finder)
الماجد - Al-Majid (The Illustrious)
الواحد - Al-Wahid (The One)
الأحد - Al-Ahad (The Unique)
الصمد - As-Samad (The Eternal)
القادر - Al-Qadir (The Capable)
المقتدر - Al-Muqtadir (The Powerful)
المقدم - Al-Muqaddim (The Advancer)
المؤخر - Al-Mu'akhir (The Delayer)
الأول - Al-Awwal (The First)
الآخر - Al-Akhir (The Last)
الظاهر - Az-Zahir (The Manifest)
الباطن - Al-Batin (The Hidden)
الوالي - Al-Wali (The Governor)
المتعالي - Al-Muta'ali (The Most High)
البر - Al-Barr (The Most Kind)
التواب - At-Tawwab (The Ever-Returning)
المنتقم - Al-Muntaqim (The Avenger)
العفو - Al-Afuw (The Pardoner)
الرحمن - Ar-Rahman (The Most Merciful)
الرحيم - Ar-Rahim (The Most Compassionate)
ملك الملك - Malik al-Mulk (The Owner of All Sovereignty)
ذو الجلال والإكرام - Dhu al-Jalal wal-Ikram (The Possessor of Majesty and Honor)
المقسط - Al-Muqsit (The Equitable)
الجامع - Al-Jami' (The Gatherer)
الغني - Al-Ghaniyy (The Self-Sufficient)
المغني - Al-Mughni (The Enricher)
المانع - Al-Mani' (The Withholder)
الضار - Ad-Darr (The Afflicter)
النافع - An-Nafi' (The Benefactor)
النور - An-Nur (The Light)
الهادي - Al-Hadi (The Guide)
البديع - Al-Badi' (The Originator)
الباقي - Al-Baqi (The Everlasting)
الوارث - Al-Warith (The Inheritor)
الرشيد - Ar-Rashid (The Rightly Guided)
الصبور - As-Sabur (The Most Patient)

# Islamic Concepts
إيمان - Iman (Faith)
إسلام - Islam (Submission)
إحسان - Ihsan (Excellence)
توحيد - Tawhid (Monotheism)
شرك - Shirk (Polytheism)
كفر - Kufr (Disbelief)
نفاق - Nifaq (Hypocrisy)
توكل - Tawakkul (Trust in God)
صبر - Sabr (Patience)
شكر - Shukr (Gratitude)
توبة - Tawbah (Repentance)
مغفرة - Maghfirah (Forgiveness)
رحمة - Rahmah (Mercy)
حكمة - Hikmah (Wisdom)
عدل - Adl (Justice)
حلم - Hilm (Forbearance)
قوة - Quwwah (Strength)
عزة - Izzah (Glory)
كبرياء - Kibriya' (Majesty)
جلال - Jalal (Glory)
جمال - Jamal (Beauty)
كمال - Kamal (Perfection)

## COMPLEX & CLASSICAL ARABIC (الكلاسيكية)

# Literary Terms
بديع - Badi' (Novelty/Originality in rhetoric)
مجاز - Majaz (Metaphor)
استعارة - Isti'arah (Metaphor)
تشبيه - Tashbih (Simile)
كناية - Kinayah (Metonymy)
تورية - Tawriyah (Double meaning)
جناس - Jinas (Wordplay)
سجع - Saj' (Rhymed prose)
موازنة - Muwazanah (Parallelism)
مقابلة - Muqabalah (Antithesis)
تضاد - Tidad (Contrast)
تفسير - Tafsir (Exegesis)
تأويل - Ta'wil (Interpretation)
إشارة - Isharah (Allusion)
رمز - Ramz (Symbol)
كنز - Kunuz (Treasure)

# Philosophical Concepts
وجود - Wujud (Existence)
عدم - Adam (Non-existence)
جوهر - Jawhar (Essence/Substance)
عرض - Arad (Accident)
ماهية - Mahiyyah (Quiddity)
حقيقة - Haqiqah (Reality)
شكل - Shakl (Form)
مادة - Maddah (Matter)
سبب - Sabab (Cause)
مسبب - Musabbab (Effect)
ضرورة - Darurah (Necessity)
إمكان - Imkan (Possibility)
امتناع - Imtina' (Impossibility)
عقل - Aql (Intellect)
نقل - Naql (Transmission)
برهان - Burhan (Proof)
دليل - Dalil (Evidence)
حجة - Hujjah (Argument)

## GRAMMATICAL ANNOTATIONS (النحوية)

# Verb Forms (أوزان الأفعال)
فعل - Fa'ala (Form I: did/made)
فعّل - Fa'ala (Form II: caused to do)
فاعل - Fa'ala (Form III: tried to do)
أفعل - Af'ala (Form IV: made something do)
تفعّل - Tafa'ala (Form V: acted as if doing)
تفاعل - Tafa'ala (Form VI: did with each other)
انفعل - Infa'ala (Form VII: was done to)
افعلّ - If'alla (Form VIII: became colored with)
استفعل - Istaf'ala (Form X: sought to do)

# Noun Patterns
فَعْل - Fa'l (Noun of action/verbal noun)
فِعْل - Fi'l (Noun of action/verbal noun)
فَعَل - Fa'al (Noun of action/verbal noun)
فَعْلَة - Fa'lah (Instance of action/verbal noun)
فُعُول - Fulul (Intensive participle)
فَاعِل - Fa'il (Active participle)
مَفْعُول - Maf'ul (Passive participle)
فَعِيل - Fa'il (Intensive/passive participle)
فَعَال - Fa'al (Intensive noun)

## NUMERICAL ANALYSIS INTEGRATION (التحليل العددي)

# Number 4: Shaitaan's Influence Factors
أربعة - Arba'ah (Four)
شيطان - Shaitan (Satan)
وسوسة - Waswasah (Whispering/temptation)
غواية - Ghawayah (Misguidance)
ضلال - Dalal (Straying)
فتنة - Fitnah (Trial/temptation)
شهوة - Shahwah (Desire/lust)
غضب - Ghadab (Anger)
حسد - Hasad (Envy)
بخل - Bukhl (Stinginess)
كبر - Kibr (Arrogance)
رياء - Rya' (Show-off)
سحر - Sihr (Magic/witchcraft)
خداع - Khida' (Deception)
مكر - Makr (Cunning/scheming)

# Mathematical Operations for Influence Tracking
طرح - Tarh (Subtraction)
نقص - Nuqsan (Decrease/deficiency)
خسارة - Khasarah (Loss)
إنقاص - Inqas (Reduction)
حذف - Hazf (Removal/elimination)
سلخ - Salkh (Peeling off/removing)

# Number 7: Unit Power Measurement
سبعة - Sab'ah (Seven)
قوة - Quwwah (Power/Strength)
قدرة - Qudrah (Ability/capacity)
سطوة - Sutwah (Might/domination)
هيمنة - Himayah (Control/dominion)
سلطان - Sultan (Authority/power)
بركة - Barakah (Blessing/power)
نفوذ - Nufudh (Influence/penetration)
تأثير - Ta'thir (Effect/impact)
فاعلية - Fa'aliyah (Effectiveness)
قوة روحية - Quwwah ruhawiyyah (Spiritual power)
قدرة إلهية - Qudrah ilahiyyah (Divine power)
طاقة - Taqah (Energy/power)
عزيمة - Azimah (Determination/resolve)
إرادة - Iradah (Will)

# Empirical Validation Concepts
تحقيق - Tahqiq (Verification/realization)
تثبت - Tatbut (Confirmation/validation)
برهان - Burhan (Proof/demonstration)
دليل - Dalil (Evidence/proof)
حقيقة - Haqiqah (Truth/reality)
واقع - Waqi' (Reality/actuality)
مشاهدة - Mushahadah (Observation/witnessing)
تجربة - Tajribah (Experiment/experience)
اختبار - Ikhtibar (Test/trial)
فحص - Fahs (Examination/check)
تحليل - Tahlil (Analysis)
دراسة - Dirasah (Study/research)
بحث - Bahth (Research/investigation)

## SPIRITUAL WARFARE TERMINOLOGY (الروحانية)

# Forces of Light vs Darkness
نور - Nur (Light)
ظلام - Zalam (Darkness)
خير - Khayr (Good)
شر - Sharr (Evil)
إيمان - Iman (Faith)
كفر - Kufr (Disbelief)
هدى - Huda (Guidance)
ضلال - Dalal (Misguidance)
حق - Haqq (Truth)
باطل - Batil (Falsehood)
صلاح - Salah (Righteousness)
فساد - Fasad (Corruption)
طهارة - Taharah (Purity)
نجاسة - Najasah (Impurity)
بر - Barr (Goodness)
إثم - Ithm (Sin)

# Protection & Defense
حفظ - Hifz (Protection/preservation)
صيانة - Siyanah (Safeguarding)
تحصين - Tahsin (Fortification)
وقاية - Wiqayah (Protection/shielding)
مخبرة - Makhbarah (Armor)
درع - Dir' (Shield)
سلاح - Silah (Weapon)
قوة - Quwwah (Strength)
عزة - Izzah (Glory/honor)
منعة - Man'ah (Power/defense)

## LINGUISTIC VARIATIONS (اللهجات)

# Classical Arabic (فصحى)
قط - Qitta (Cat)
أم - Umm (Mother)
أب - Ab (Father)
أخ - Akh (Brother)
أخت - Ukht (Sister)
ابن - Ibn (Son)
بنت - Bint (Daughter)

# Common Variations
بس - Bas (But/enough)
تمام - Tamam (Perfect/complete)
طيب - Tayyib (Good/fine)
أكيد - Akeed (Sure/certain)
بالعربي - Bil'arabi (In Arabic)

# Regional Terms
شاي - Shay (Tea)
قهوة - Qahwah (Coffee)
ماء - Ma' (Water)
خبز - Khubz (Bread)
لحم - Lahm (Meat)
سمك - Samak (Fish)
خضار - Khudar (Vegetables)
فواكه - Fawakih (Fruits)

## TECHNICAL & SCIENTIFIC TERMINOLOGY (العلمية)

# Sciences
علم - Ilm (Science/knowledge)
رياضيات - Riyadiyat (Mathematics)
فيزياء - Fiziya (Physics)
كيمياء - Kimiya (Chemistry)
أحياء - Hayawat (Biology)
جيولوجيا - Jiyulujiya (Geology)
فلك - Falak (Astronomy)
طب - Tibb (Medicine)
هندسة - Handasah (Engineering)
حاسوب - Hasub (Computer)

# Technical Terms
برمجة - Barimajah (Programming)
خوارزمية - Khuwarizmiyyah (Algorithm)
شبكة - Shabakah (Network)
إنترنت - Internet (Internet)
بيانات - Bayanat (Data)
معلومة - Ma'lumah (Information)
نظام - Nidham (System)
برنامج - Barnamaj (Program)
تطبيق - Tatbiq (Application)
واجهة - Wajihah (Interface)

## FINANCIAL & ECONOMIC TERMS (الاقتصادية)

# Currency & Trade
مال - Mal (Money/wealth)
ثروة - Tharwah (Richness/fortune)
تجارة - Tajarah (Trade/commerce)
بيع - Bay' (Sale)
شراء - Shira' (Purchase)
سعر - Si'r (Price)
قيمة - Qimah (Value)
ربح - Ribh (Profit)
خسارة - Khasarah (Loss)
دين - Dayn (Debt)
ائتمان - I'timan (Credit)
استثمار - Istithmar (Investment)
اقتصاد - Iqtisad (Economy)
سوق - Suq (Market)
بنك - Bank (Bank)

# Economic Concepts
عرض - Ard (Supply)
طلب - Talab (Demand)
إنتاج - Intaj (Production)
استهلاك - Istihlak (Consumption)
ادخار - Idkhar (Saving)
نفقات - Nafaqat (Expenses)
دخل - Dakhul (Income)
ميزانية - Mizaniyah (Budget)
ضرائب - Dara'ib (Taxes)
جمارك - Jamarik (Customs)

## LEGAL & JUDICIAL TERMS (القانونية)

# Islamic Law
شريعة - Shari'ah (Islamic law)
فقه - Fiqh (Jurisprudence)
قضاء - Qada (Judgment)
قانون - Qanun (Law)
عقد - Aqd (Contract)
شهادة - Shahadah (Testimony)
بينة - Bayyinah (Evidence)
حكم - Hukm (Ruling/verdict)
فتوى - Fatwa (Legal opinion)
إجماع - Ijma (Consensus)
قياس - Qiyas (Analogical reasoning)
اجتهاد - Ijtihad (Independent reasoning)

# Legal Actions
دعوى - Da'wa (Lawsuit)
دفاع - Difa' (Defense)
اتهام - Ittihah (Accusation)
براءة - Bara'ah (Innocence)
إدانة - Idanah (Conviction)
عقوبة - Uqubah (Punishment)
غرامة - Ghamamah (Fine)
سجن - Sijn (Prison)
إطلاق سراح - Itlaq sarah (Release)
تعويض - Ta'wid (Compensation)

## MODERN TECHNOLOGY TERMS (التكنولوجيا الحديثة)

# Digital Technology
ذكاء اصطناعي - Dhaka' istina'i (Artificial intelligence)
تعلم آلة - Ta'allum alah (Machine learning)
تحليل بيانات - Tahlil bayanat (Data analysis)
سحابة - Sahabah (Cloud)
تشفير - Tashfir (Encryption)
أمن سيبراني - Amn saybirani (Cybersecurity)
بلوك تشين - Blockchain (Blockchain)
عملة رقمية - Amlah raqamiyyah (Digital currency)
واقع افتراضي - Waqi' iftira'i (Virtual reality)
واقع معزز - Waqi' mu'azzaz (Augmented reality)

# Communication Technology
هاتف - Hatif (Telephone)
جوال - Jawwal (Mobile phone)
رسالة - Risalah (Message)
بريد إلكتروني - Barid iliktroni (Email)
مؤتمر فيديو - Mu'tamar video (Video conference)
شبكة اجتماعية - Shabakah ijtimaiyyah (Social network)
بث مباشر - Bath mubashar (Live streaming)
محتوى - Muhtawa (Content)
منصة - Mansah (Platform)
تطبيق - Tatbiq (Application)

## EMOTIONAL & PSYCHOLOGICAL TERMS (النفسية)

# Emotions
فرح - Farah (Joy/Happiness)
حزن - Huzn (Sadness/Grief)
غضب - Ghadab (Anger)
خوف - Khawf (Fear)
حب - Hubb (Love)
كره - Karah (Hate)
امل - Amal (Hope)
يأس - Ya's (Despair)
غيرة - Ghayrah (Jealousy)
حسد - Hasad (Envy)
فخر - Fakhr (Pride)
خجل - Haya' (Shyness)
اطمئنان - Itmi'nan (Reassurance)
قلق - Qalaq (Anxiety)
راحة - Rahah (Comfort)

# Psychological States
عقل - Aql (Mind/Intellect)
قلب - Qalb (Heart/Emotion)
روح - Ruh (Soul/Spirit)
نفس - Nafs (Self/Psyche)
وعي - Wa'y (Consciousness)
لاوعي - La wa'y (Unconscious)
ذاكرة - Dhakirah (Memory)
تفكير - Tafkir (Thinking)
إدراك - Idrak (Perception)
انتباه - Intibah (Attention)
تركيز - Tarkiz (Concentration)
تأمل - Ta'ammul (Meditation/Reflection)

## MEDICAL & HEALTH TERMS (الطبية)

# Body Parts
رأس - Ra's (Head)
عين - Ayn (Eye)
أذن - Udhun (Ear)
أنف - Anf (Nose)
فم - Fam (Mouth)
قلب - Qalb (Heart)
رئة - Ri'ah (Lung)
معدة - Ma'idah (Stomach)
كبد - Kabid (Liver)
كلية - Kulayyah (Kidney)
يد - Yad (Hand)
قدم - Qadam (Foot)
ظهر - Zahr (Back)
بطن - Batn (Abdomen)

# Medical Conditions
مرض - Marad (Disease/Illness)
صحة - Sihhah (Health)
علاج - Ilaj (Treatment)
دواء - Dawa' (Medicine)
جراحة - Jirahah (Surgery)
حمى - Huma (Fever)
ألم - Alam (Pain)
إصابة - Isabah (Injury)
كسر - Kasr (Fracture)
ورم - Warm (Tumor/Swelling)
التهاب - Iltihab (Inflammation)
عدوى - Adwa (Infection)

## EDUCATIONAL & ACADEMIC TERMS (التعليمية)

# Education Levels
مدرسة - Madrasah (School)
جامعة - Jami'ah (University)
كلية - Kulliyah (College/Institute)
معهد - Ma'had (Institute)
روضة - Rawdah (Kindergarten)
ابتدائي - Ibtida'i (Primary)
إعدادي - Idadi (Preparatory)
ثانوي - Thanawi (Secondary)
عالي - Ali (Higher)
دراسات عليا - Dirasat uliya (Graduate studies)

# Academic Activities
دراسة - Dirasah (Study)
بحث - Bahth (Research)
تحليل - Tahlil (Analysis)
مناقشة - Munaqashah (Discussion)
امتحان - Imtihan (Exam)
شهادة - Shahadah (Certificate/Degree)
تدريس - Tadris (Teaching)
تعلم - Ta'allum (Learning)
تدريب - Tadrib (Training)
مؤتمر - Mu'tamar (Conference)

## ENVIRONMENTAL & NATURAL TERMS (البيئية)

# Natural Elements
أرض - Ard (Earth/land)
سماء - Sama' (Sky/sky)
ماء - Ma' (Water)
هواء - Hawa' (Air)
نار - Nar (Fire)
ضوء - Daw' (Light)
ظل - Dhill (Shadow)
حرارة - Hararah (Heat)
برودة - Burudah (Cold)
ريح - Rih (Wind)
مطر - Matar (Rain)
ثلج - Thalj (Snow)
ضباب - Dhabab (Fog)
رعد - Ra'd (Thunder)
برق - Barq (Lightning)

# Environment
بيئة - Bi'ah (Environment)
طبيعة - Tabi'ah (Nature)
حياة - Hayah (Life)
نظام بيئي - Nidham bi'i (Ecosystem)
تنوع حيوي - Tanawwuh hayawi (Biodiversity)
تلوث - Tulluth (Pollution)
حفاظ - Hifaz (Conservation)
استدامة - Istidamah (Sustainability)
موارد طبيعية - Muwarid tabi'iyyah (Natural resources)
طاقة متجددة - Taqah mutajaddidah (Renewable energy)

## CULTURAL & ARTISTIC TERMS (الثقافية والفنية)

# Arts
فن - Fann (Art)
رسم - Rasm (Drawing/Painting)
نحت - Nahat (Sculpture)
موسيقى - Musiqa (Music)
غناء - Ghina' (Singing)
رقص - Rags (Dance)
شعر - Shi'r (Poetry)
أدب - Adab (Literature)
مسرح - Masrah (Theater)
سينما - Sinima (Cinema)

# Cultural Elements
ثقافة - Thaqafah (Culture)
تراث - Turath (Heritage)
عادات - Adat (Customs)
تقاليد - Taqalid (Traditions)
لغة - Lughah (Language)
لهجة - Lahjah (Dialect)
فولكلور - Folklor (Folklore)
أسطورة - Usthurah (Myth/Legend)

# END OF COMPREHENSIVE ARABIC LEXICON LIBRARY
# This library contains over 500+ terms with annotated meanings
#涵盖: Standard Arabic, Classical Arabic, Religious Terminology, Numerical Analysis
# Integration ready for Falaqi program enhancement